------------------
-                -
- ---- ---- ---- -
- -  -           -
- - -- -- -- --- -
- -  -           -
- - -- -- -- --- -
- -  -           -
- -- - ---- ---- -
-                -
- -- - ---- ---- -
- -  -           -
- - -- -- -- --- -
- -  -           -
- - -- -- -- --- -
- -  -           -
- ---- ---- ---- -
-                -
------------------
