--------------------
-                  -
- ---- ---- --- ----
- -                -
- - -- ---- -- -----
- -                -
- - -- -- ---- -----
- -                -
- - -- -- -- -- ----
- -                -
- - ---------- -----
- -                -
- - ---- ---- ---- -
- -                -
- - ---- ---- ---- -
- -                -
- - ---- ---- ---- -
- -                -
- - ---- ---- ---- -
- -                -
- ---- -------- ----
-                  -
--------------------
