----------------
-              -
- -------- --- -
- -          - -
- - --- ---- - -
- -          - -
- - - - ---- - -
- - - -      - -
- - - - --- -- -
- - -          -
- - ---------- -
- -            -
- --- -------- -
-              -
----------------